NO ./texture/noth
SO ./texture/south
WE ./texture/west
EA ./texture/east

F 220,100,0
C 225,256,0

111111
100101
101001
1100N1
111111