NO ./texture/north.png
SO ./texture/south.png
WE ./texture/west.png
EA ./texture/east.png

FF 220,100,0
C 225,30,0

111111
100101
101001
1100N1
111111