NO ./texture/noth
SO ./texture/south
WE ./texture/west
EA ./texture/east

F 220,100,0
C 225,30,0

111101
100101
101001
1100N1
111111