NO ./texture/north.xpm
SO ./texture/south.xpm
WE ./texture/west.xpm
EA ./texture/east.xpm

F 220,100,0
C 225,30,0

110111
100101
101001
1100N1
111111